###############-################
--------------#-#---------------
###-#####-#####-######-#####-###
#-#--------------------------#-#
#-#-########################-#-#
#---#                      #---#
#-#-# ######################-#-#
###-# #----------------------###
----# #-####-#########-####-----
-##-# #----------------------##-
-##-# ######################-##-
###-#                      #-###
-##-########################--##
-##------#####------#####-----##
----####-------####-------##----
###------#####------#####----###