##############------############
--------------------------------
###-#####-#####-######-#####-###
#-#--------------------------#-#
#---########################---#
#---#                      #---#
#-#-# ######################-#-#
###-# #----------------------###
----# #-####-#########-####-----
-#--# #-----------------------#-
-#--# ######################--#-
###-#                      #-###
-#--########################--#-
-#----------------------------#-
----####-------####-------##----
###------#####------#####----###