################################
-------------------------------#
#-##############################
#-#----------------------------#
#-#----------------------------#
#-#----------------------------#
#-#----------------------------#
#-#----------------------------#
#-#----------------------------#
#-#----------------------------#
#-#----------------------------#
#-#----------------------------#
#-#----------------------------#
#-#----------------------------#
#-#----------------------------#
################################